20 50 Sewer
-127 -124 -127 -127 -127 -127 -127 -127 -127 -127 -124 -127 -127 -127 -127 -124 -127 -127 -127 -127 -127 -124 -127 -127 -127 -127 -127 -127 -124 -127 -127 -127 -124 -127 -127 -124 -124 -127 -127 -124 -127 197 197 -1 -1 -1 -1 -1 -1 -1
-127 -127 -127 -127 -124 -127 -127 -127 -127 -127 -127 -127 -127 -127 -127 -127 -127 -127 -127 -124 -127 -127 -127 -125 -126 -126 -127 -127 -124 -127 -127 -124 -106 -107 -108 -109 -127 -127 -127 -127 -124 197 197 -1 -1 -1 -1 -1 -1 -1
-127 -127 -127 -127 -127 -127 -127 -124 -127 -127 -127 -127 -124 -127 -127 -127 -127 -127 -127 -127 -127 -127 -127 -144 -145 -145 -127 -127 -127 -127 -127 -124 -127 -127 -127 -115 -127 -124 -127 -127 -127 221 197 -1 -1 -1 -1 -1 -1 -1
-127 -127 -127 -124 -127 -127 -124 -127 -124 -127 -127 -127 -127 -127 -127 -124 -127 -127 -127 -127 -127 -124 -127 -127 -127 -127 -127 -124 -127 -127 -127 -127 -127 -127 -124 -127 -127 -127 -124 -127 -127 222 197 -1 -1 -1 -1 -1 -1 -1
-124 -127 -127 -127 -127 -127 -127 -127 -127 -127 -127 -127 -127 -127 -127 -127 -127 -127 -127 -127 -127 -127 -127 -127 -124 -127 -127 -127 -127 -127 -127 -124 -127 -127 -124 -127 -127 -127 -124 -124 -124 222 197 -1 -1 -1 -1 -1 -1 -1
-127 -127 -127 -124 -127 -127 -127 -127 -127 -124 -127 -127 -127 -127 -124 -127 -127 -127 -127 142 143 144 145 146 147 -127 -127 -127 -127 -124 -127 -127 -127 -127 -127 -127 -124 -127 -127 -127 -127 222 197 -1 -1 -1 -1 -1 -1 -1
-127 -127 -127 -127 -127 -124 -127 -127 -127 -127 -127 -127 -127 -127 -127 -127 -127 -127 -127 -124 -127 -127 -127 -127 -124 -127 -127 -124 -127 -127 -127 -127 -124 -127 -127 -127 -124 -127 -127 -124 -127 222 197 -1 -1 -1 -1 -1 -1 -1
-127 -127 -127 -127 -127 -127 -127 176 177 177 178 177 176 177 178 177 -127 -127 -127 -127 -127 -127 -127 -127 -127 -127 -127 -127 -127 -127 -127 -127 -127 -127 -127 -127 -127 -127 -127 -127 -127 222 197 -1 -1 -1 -1 -1 -1 -1
-127 -124 -127 -127 -127 -127 -127 -124 -127 -127 -127 -127 -124 -127 -127 -127 -124 -127 -127 -127 -127 -127 -127 -127 -124 -127 -127 -127 -127 214 215 216 217 218 219 220 -127 -127 -124 -127 -127 222 197 -1 -1 -1 -1 -1 -1 -1
-127 -127 -127 -124 -127 -127 -127 -127 -127 -127 -127 -127 -127 -127 -127 -127 -127 -127 -127 -124 -127 -127 -124 -127 -127 -127 -127 -127 -127 -124 -124 -127 -127 -127 -124 -127 -127 -127 -124 -127 -127 222 197 -1 -1 -1 -1 -1 -1 -1
-124 -127 -127 -127 -127 -127 -127 -127 -127 -127 -127 -127 -127 -127 -127 -127 -127 -127 -124 -127 -127 -127 -127 -124 -127 -127 -127 -127 -124 -127 -127 -127 -127 -127 -124 -127 -127 -127 -127 -124 -127 222 197 -1 -1 -1 -1 -1 -1 -1
-127 -127 -127 -127 -127 -127 -127 -124 -127 -127 -127 -127 -124 -127 -127 -127 197 142 197 197 142 142 197 -127 -127 -127 -127 -127 -127 -127 -127 -127 -127 -127 -127 -127 -127 -127 -124 -127 -127 222 197 -1 -1 -1 -1 -1 -1 -1
-127 -127 -124 -127 -124 -127 -127 -127 -127 -127 -127 -127 -127 -127 -127 -127 -127 -127 -127 -127 -127 -124 -127 -127 -127 -127 -127 -124 -127 -127 -124 -127 -127 -127 -127 -127 -127 -127 -127 -127 -127 223 197 -1 -1 -1 -1 -1 -1 -1
-127 -127 -127 -127 -127 -127 -127 -127 -124 -127 -127 -127 -127 -127 -124 -127 -127 -127 -127 -127 -127 -127 -127 -127 -127 -124 -127 -124 -127 -127 -127 -127 -124 -127 -127 -127 -124 -127 -127 -127 -127 197 197 -1 -1 -1 -1 -1 -1 -1
-127 -127 -127 -127 -127 -127 -127 -127 -127 -127 -127 -127 -127 -127 -127 -127 -127 -127 -127 -127 -127 -127 -127 -127 -127 -127 -127 -127 -127 -127 -127 -127 -127 -127 -127 -127 -127 -127 -127 -127 -127 197 197 -1 -1 -1 -1 -1 -1 -1
-1 -1 -1 -1 -1 -1 -1 -1 -1 -1 -1 -1 -1 -1 -1 -1 -1 -1 -1 -1 -1 -1 -1 -1 -1 -1 -1 -1 -1 -1 -1 -1 -1 -1 -1 -1 -1 -1 -1 -1 -1 -1 -1 -1 -1 -1 -1 -1 -1 -1
-1 -1 -1 -1 -1 -1 -1 -1 -1 -1 -1 -1 -1 -1 -1 -1 -1 -1 -1 -1 -1 -1 -1 -1 -1 -1 -1 -1 -1 -1 -1 -1 -1 -1 -1 -1 -1 -1 -1 -1 -1 -1 -1 -1 -1 -1 -1 -1 -1 -1
-1 -1 -1 -1 -1 -1 -1 -1 -1 -1 -1 -1 -1 -1 -1 -1 -1 -1 -1 -1 -1 -1 -1 -1 -1 -1 -1 -1 -1 -1 -1 -1 -1 -1 -1 -1 -1 -1 -1 -1 -1 -1 -1 -1 -1 -1 -1 -1 -1 -1
-1 -1 -1 -1 -1 -1 -1 -1 -1 -1 -1 -1 -1 -1 -1 -1 -1 -1 -1 -1 -1 -1 -1 -1 -1 -1 -1 -1 -1 -1 -1 -1 -1 -1 -1 -1 -1 -1 -1 -1 -1 -1 -1 -1 -1 -1 -1 -1 -1 -1
-1 -1 -1 -1 -1 -1 -1 -1 -1 -1 -1 -1 -1 -1 -1 -1 -1 -1 -1 -1 -1 -1 -1 -1 -1 -1 -1 -1 -1 -1 -1 -1 -1 -1 -1 -1 -1 -1 -1 -1 -1 -1 -1 -1 -1 -1 -1 -1 -1 -1
