20 50 Sewer
197 197 197 -156 -156 -156 -156 -156 -156 -156 -156 -156 -156 -156 -156 -156 -156 -156 -156 -156 -156 -156 -156 -156 -156 -156 -156 -156 -156 -156 -156 -156 -156 -156 -156 -156 -156 -156 -156 -156 197 197 197 -1 -1 -1 -1 -1 -1 -1
197 197 197 -156 -156 -156 -156 -156 -156 -156 -156 -156 -156 -156 -156 -156 -156 -156 -156 -156 -156 -156 -156 -156 -156 -156 -156 -156 -156 -156 -156 -156 -125 -126 -126 -156 -156 -156 -156 -156 197 197 197 -1 -1 -1 -1 -1 -1 -1
197 197 197 -156 -156 -106 -107 -108 -109 -156 -156 -156 -156 -156 -156 -156 -156 -156 -156 -156 -156 -156 -156 -156 -156 -156 -156 -156 -156 -156 -156 -156 -144 -145 -145 -156 -156 -156 -156 -156 197 197 197 -1 -1 -1 -1 -1 -1 -1
197 197 197 -156 -156 -156 -156 -156 -115 -156 -156 -156 -156 -156 -156 -156 -156 -156 -156 -156 -156 -156 -156 -156 -156 -156 -156 -156 -156 -156 -156 -156 -156 -156 -156 -156 -156 -156 -156 -156 219 197 197 -156 -1 -1 -1 -1 -1 -1
197 197 219 -156 -156 -156 -156 -156 -156 -156 -156 -156 -156 -156 -156 -156 -156 -156 -156 -156 -156 -156 -156 -156 -156 -156 -156 -156 -156 -156 -156 -156 -156 -156 -156 -156 -156 -156 -156 -156 220 197 197 -1 -1 -1 -1 -1 -1 -1
197 197 220 -156 -156 -156 -156 -156 -156 -156 -156 -156 -156 -156 -156 -156 -156 -156 214 215 216 217 216 217 216 217 214 -156 -156 -156 -156 -156 -156 -156 -156 -156 -156 -156 -156 -156 221 197 197 -1 -1 -1 -1 -1 -1 -1
197 197 221 -156 -156 -156 -156 -156 -156 -156 -156 -156 -156 -156 -156 -156 -156 -156 -156 -156 -156 -156 -156 -156 -156 -156 -156 -156 -156 -156 -156 -156 -156 -156 -156 -156 -156 -156 -156 -156 222 197 197 -1 -1 -1 -1 -1 -1 -1
197 197 222 -156 -156 -156 -156 -156 -156 -156 -156 -156 -156 -156 -156 -156 -156 -156 -156 -156 -156 -156 -156 -156 -156 -156 -156 -156 -156 -156 -156 -156 -156 -156 -156 -156 -156 -156 -156 -156 221 197 197 -1 -1 -1 -1 -1 -1 -1
197 197 221 -156 -156 -156 -156 -156 -156 -156 -156 -156 -156 -156 -156 -156 -156 -156 -156 -156 -156 -156 -156 -156 -156 -156 -156 -156 -156 -156 -156 -156 -156 -156 -156 -156 -156 -156 -156 -156 222 197 197 -1 -1 -1 -1 -1 -1 -1
197 197 222 -156 -156 -156 -156 -156 -156 -156 214 215 216 217 214 -156 -156 -156 -156 -156 -125 -126 -156 -156 -156 -156 -156 -156 -156 -156 -156 -156 -156 -156 -156 -156 -156 -156 -156 -156 221 197 197 -1 -1 -1 -1 -1 -1 -1
197 197 221 -156 -156 -156 -156 -156 -156 -156 -156 -156 -156 -156 -156 -156 -156 -156 -156 -156 -144 -145 -156 -156 -156 -156 -156 -156 -156 -156 -156 -156 -156 -156 -156 -156 -156 -156 -156 -156 222 197 197 -1 -1 -1 -1 -1 -1 -1
197 197 222 -156 -156 -156 -156 -156 -156 -156 -156 -156 -156 -156 -156 -156 -156 -156 -156 -156 -156 -156 -156 -156 -156 -156 -156 -156 -156 214 215 216 217 216 217 216 214 -156 -156 -156 219 197 197 -1 -1 -1 -1 -1 -1 -1
197 197 219 -156 -156 -156 -156 -156 -156 -156 -156 -156 -156 -156 -156 -156 -156 -156 -156 -156 -156 -156 -156 -156 -156 -156 -156 -156 -156 -156 -156 -156 -156 -156 -156 -156 -156 -156 -156 -156 197 197 197 -1 -1 -1 -1 -1 -1 -1
197 197 197 -156 -156 -156 -156 -156 -156 -156 -156 -156 -156 -156 -156 -156 -156 -156 -156 -156 -156 -156 -156 -156 -156 -156 -156 -156 -156 -156 -156 -156 -156 -156 -156 -156 -156 -156 -156 -156 197 197 197 -156 -1 -1 -1 -1 -1 -1
197 197 197 -156 -156 -156 -156 -156 -156 -156 -156 -156 -156 -156 -156 -156 -156 -156 -156 -156 -156 -156 -156 -156 -156 -156 -156 -156 -156 -156 -156 -156 -156 -156 -156 -156 -156 -156 -156 -156 197 197 197 -1 -1 -1 -1 -1 -1 -1
-1 -1 -1 -1 -1 -1 -1 -1 -1 -156 -1 -1 -1 -1 -1 -1 -1 -156 -1 -1 -1 -156 -1 -156 -1 -1 -1 -1 -1 -1 -1 -1 -1 -1 -1 -1 -1 -156 -1 -1 -1 -156 -1 -1 -1 -1 -1 -1 -1 -1
-1 -1 -1 -1 -1 -1 -1 -1 -1 -1 -1 -1 -1 -1 -1 -1 -1 -1 -1 -1 -1 -1 -1 -1 -1 -1 -1 -1 -1 -1 -1 -1 -1 -1 -1 -1 -1 -1 -1 -1 -1 -1 -1 -1 -1 -1 -1 -1 -1 -1
-1 -1 -1 -1 -1 -1 -1 -1 -1 -1 -1 -1 -1 -1 -1 -1 -1 -1 -1 -1 -1 -1 -1 -1 -1 -1 -1 -1 -1 -1 -1 -1 -1 -1 -1 -1 -1 -1 -1 -1 -1 -1 -1 -1 -1 -1 -1 -1 -1 -1
-1 -1 -1 -1 -1 -1 -1 -1 -1 -1 -1 -1 -1 -1 -1 -1 -1 -1 -1 -1 -1 -1 -1 -1 -1 -1 -1 -1 -1 -1 -1 -1 -1 -1 -1 -1 -1 -1 -1 -1 -1 -1 -1 -1 -1 -1 -1 -1 -1 -1
-1 -1 -1 -1 -1 -1 -1 -1 -1 -1 -1 -1 -1 -1 -1 -1 -1 -1 -1 -1 -1 -1 -1 -1 -1 -1 -1 -1 -1 -1 -1 -1 -1 -1 -1 -1 -1 -1 -1 -1 -1 -1 -1 -1 -1 -1 -1 -1 -1 -1
